


####################
######   o   #######
#                  #
#                  #
####   #############
#                  #
#                  #
###   ######  ######
#                  #
#                  #
########         ###
#                  #
#                  #
###     ############
#                  #
#                  #
##############  ####
#                  #
#                  #
########  #####    #
#                  #
#                  #
###########    #####
#                  #
#                  #
####    ############
#                  #
#                  #
########    ########
#                  #
#                  #
###########       ##
#                  #
#                  #
######      ########
#                  #
#                  #
#       ###    #####
#                  #
#                  #
#        ###########
#                  #
#                  #
#####         #    #
#                  #
#                  #
#                  #