#                  #
#                  #
#                  #
##      #######   ##
#                  #
#                  #
#########      #####
#                  #
#                  #
###       #####  ###
#                  #
#                  #
###   ###########  #
#                  #
#                  #
######  ####  ###  #
#                  #
#                  #
##########       ###
#                  #
#                  #
####     ###########
#                  #
#                  #
####  #########    #
#                  #
#                  #
#  #############   #
#                  #
#                  #
######    ##########
#                  #
#                  #
############       #
#                  #
#                  #
######     #########
#                  #
#                  #
################   #
#                  #
#                  #
###   ######## #####
#                  #
#                  #
######   o   #######
####################



