#                  #
#                  #
#                  #
#####  ####  ###  ##
#                  #
#                  #
########  ##########
#                  #
#                  #
#############      #
#                  #
#                  #
#    ###### ########
#                  #
#                  #
###  ###########   #
#                  #
#                  #
########    ########
#                  #
#                  #
##   ###############
#                  #
#                  #
## #######         #
#                  #
#                  #
####  ##############
#                  #
#                  #
#######   #######  #
#                  #
#                  #
##  #######        #
#                  #
#                  #
######   ###########
#                  #
#                  #
##############     #
#                  #
#                  #
#####   ####### ####
#                  #
#                  #
######   o   #######
####################



